10 10
3333333620
3333335320
3333343320
3333333320
3333333320
3333333320
3333333320
3333333320
1111111100
0000000000
