0
0 0 0 0
10 10
3333333320
3944449320
3433334320
3433334320
3433334320
3433334320
3944449320
3333333320
1111111100
0000000000
